haggl	haggling
profici	proficient
woodi	woody
undersecretari	undersecretary
reprocess	reprocessing
bear	bear,bearing
poorli	poorly
four	four
secondli	secondly
protest	protesters
asian	asian
battleground	battleground
inara	inara
consider	considerably,consideration,considerable
whose	whose
accus	accused,accusations,accusing
undef	undefeated
spin	spin,spinning
tweet	tweeted
invas	invasive
list	list,lists,listing
concret	concrete
inart	inartful
sputter	sputter
hedg	hedging
worth	worth
milit	militants
everi	every
risk	risk,risks,risking
vastli	vastly
rise	rises
voic	voices
ident	identity,identical
jack	jack
govern	government,governments,governance
affect	affect,affects,affected
meddl	meddling,meddle
school	school
ignit	ignite
osirak	osirak
factori	factories,factory
verif	verification
triumph	triumph
suzann	suzanne
jeff	jeff
chew	chew
widow	widower
direct	direction,directions
consequ	consequences
second	second
street	streets
empow	empower,empowered
parochi	parochial
akbar	akbar
longstand	longstanding
even	even
aim	aimed
settlement	settlement
hide	hide
worsen	worsen
neg	negative
pragmatist	pragmatists
asid	aside
weren	weren
asia	asia
conduct	conduct,conducting,conducted
supplier	supplier,suppliers
new	new
net	net
dynasti	dynasty
ever	ever
preemptiv	preemptively
hazi	hazy
told	told
ongo	ongoing
asymmetri	asymmetry
avert	avert,averting
never	never
met	met
nonmilitari	nonmilitary
china	china
undo	undo
underway	underway
path	path
interpret	interpreting,interprets,interpretations
vagu	vague
deterior	deteriorating,deteriorate
eugen	eugene
militari	military
anymor	anymore
envoy	envoy
precis	precisely
yield	yielding
permit	permitted
bunker	bunker
studi	study,studies,studying
theori	theory,theories
tremend	tremendous
whatnot	whatnot
imposs	impossible,impossibility
campaign	campaign
tempt	tempted
lengthen	lengthen
brought	brought
thrust	thrust
pound	pounds
moral	morally
instabl	instability
total	total,totally
unit	united
highli	highly
plot	plot
describ	described,describes
would	would
palestinian	palestinian
injunct	injunction
deviat	deviation
panacea	panacea
asset	assets
recommend	recommend
strike	strikes,striking
rattl	rattling
tell	tell
pipework	pipework
saber	saber
relax	relaxed,relaxation,relaxes
relat	relate,related,relations,relating
notic	noticed
hurt	hurt
warn	warned,warning
warm	warming
grandfath	grandfathered
accur	accurate
qualm	qualms
hole	hole
hold	hold,holding
overrul	overrule
must	must
shoot	shoot
word	words
room	room
restor	restored,restoration
work	work,works,working
conceptu	conceptual
wors	worse
introduc	introducing,introduce
mr	mrs
proscript	proscriptions
fitzpatrick	fitzpatrick
overrid	override
defer	deference
climat	climate
give	giving,gives
virtu	virtue,virtues
india	india
indic	indicating,indicates,indication
cautiou	cautious
coalit	coalition
malign	malign
caution	caution
refus	refuse,refused,refusal,refuses
want	wanted,wants
keep	keep,keeping,keeps
attract	attractive
rid	ridding
end	ended,ends
turn	turned,turning,turns
hashemi	hashemi
travel	travel
classifi	classified
specter	specter
disappear	disappear
interview	interview,interviews
disappoint	disappointed
negoti	negotiate,negotiated,negotiations,negotiator,negotiating,negotiators
perspect	perspective,perspectives
polit	political,politics,politically
recogn	recognized,recognizes
lai	lai
chines	chinese
earlier	earlier
altogeth	altogether
wrong	wrong
lay	lays
substant	substantive
law	law,laws
parallel	parallel
averag	average
reshap	reshaped
alacr	alacrity
profess	professions
attempt	attempt,attempts
third	third,thirds
grant	grant,grants,granted
greet	greeted
think	think,thinking,thinks
detent	detention
perform	performing,performance
maintain	maintain,maintained,maintains,maintaining
green	green
superpow	superpower
incorpor	incorporated
enter	entered
exclus	exclusion,exclusively
worst	worst
order	order
wind	wind
origin	original,originally
crumbl	crumble,crumbling
offici	officials,officially
failur	failure
surrend	surrender
privileg	privileged
incid	incident,incidences
rashli	rashly
japan	japan
flexibl	flexibility
vari	varying
unpreced	unprecedented
fit	fits
pollackcount	pollackcountering
unforeseen	unforeseen
hezbollah	hezbollah
defector	defectors
better	better
spoken	spoken
offic	office,officer
complex	complex,complexes
persist	persistent,persistently
comprehens	comprehensive
hidden	hidden
easier	easier
undercut	undercut
proce	proceeds
enrich	enriched,enrichment,enriching
notwithstand	notwithstanding
safe	safely
unthink	unthinkable
promis	promise,promised,promises,promising
coffer	coffers
german	german
interrupt	interrupting
blink	blink
bank	banking,banks
choic	choice
tendenc	tendency
victori	victory
chuck	chuck
bonu	bonus
herald	heralding
accommod	accommodating
neutron	neutron
arrow	arrow
went	went
european	european,europeans
oblig	obligations,obligating
side	side,sided,sides
bone	bones
mean	means,meaning
prohibit	prohibitions,prohibited,prohibits
unreport	unreported
resum	resume,resuming
exactli	exactly
stronger	stronger
arduou	arduous
wednesday	wednesday
vote	votes,voted,voting
allay	allay
commiss	commission
ring	ring
whip	whips
contend	contend
depress	depressed
network	network
goe	goes
kuwait	kuwait
mogherini	mogherini
crucial	crucial,crucially
monitor	monitoring,monitors,monitored
content	contention
method	methods
laid	laid
adjust	adjusting
got	got
strategist	strategists
mccarthi	mccarthy
barrier	barrier
veto	veto,vetoing
wherea	whereas
situat	situation
free	free,freeing
standard	standards
binyamin	binyamin
speedi	speedy
workaround	workarounds
argument	arguments
isi	isis
hopeless	hopelessness
misconcept	misconceptions
target	target,targeting
onto	onto
suppos	supposed
rand	rand
rang	range
render	render
grade	grade
independ	independent
purdastan	purdastan
rank	ranks
necess	necessity
restrict	restrictions,restricted,restrictive
email	email
unlik	unlike,unlikely
alreadi	already
wasn	wasn
agre	agrees,agreed,agreeing
primari	primary
nomin	nomination
top	top
sometim	sometimes
fiction	fiction
cumul	cumulative
ton	tons
qasem	qasem
similarli	similarly
salienc	salience
john	john
bitter	bitter
clinch	clinching
unend	unending
geneva	geneva
tool	tools
took	took
wisdom	wisdom
western	western
somewhat	somewhat
conserv	conservatives
nonpartisan	nonpartisan
technic	technical
spoiler	spoiler
discourag	discouraging
provid	providing,provide,provides,provided
rate	rate
project	projects
matter	matters,mattered
iron	ironically
minut	minute
provis	provisions
fashion	fashion
contenti	contentious
entail	entail
ran	ran
pertain	pertain
modern	modern,modernize
reassur	reassuring,reassurance,reassure
spectrum	spectrum
cohes	cohesive
increment	incremental
seen	seen
seem	seems,seemed
seek	seeks,seeking
dozen	dozens
abroad	abroad
strength	strength
realm	realm
unresolv	unresolved
frontrunn	frontrunners
punish	punishment,punishing,punished
thoma	thomas
thoroughli	thoroughly
prerog	prerogative
wherebi	whereby
crippl	crippling,crippled
germani	germany
plenti	plenty
though	though
object	object,objections,objective,objects,objected
sue	sue
tenabl	tenable
regular	regular
letter	letter
phase	phased
insul	insulating
coin	coin
tradit	traditional
excus	excuse
incredul	incredulous
alarm	alarm,alarms
camp	camp
flow	flow
declar	declared,declaring,declarations
worldwid	worldwide
javandefar	javandefar
section	section,sections
came	came
treati	treaty
profoundli	profoundly
bomb	bomb,bombs,bombings
reactor	reactor,reactors
coup	coups
opposit	opposite,opposition
decidedli	decidedly
advisori	advisory
qaeda	qaeda
radio	radio
radic	radically
protocol	protocol
environ	environment
involv	involvement,involved,involves,involving
despit	despite
northeast	northeast
acquir	acquiring,acquire,acquired
pledg	pledged,pledges,pledging
explain	explaining,explained
restaur	restaurant
bust	busting
bush	bush
busi	business,businesses
rich	rich
mend	mend
virtuou	virtuous
rice	rice
oct	oct
bahrain	bahrain
recoveri	recovery
likewis	likewise
watch	watching
compli	comply,complies,complying
ceil	ceilings
hurdl	hurdles
report	report,reporters,reports
reconstruct	reconstruction
mutual	mutually
reengin	reengineer
earn	earn
bar	bars,barred
secretari	secretary
bag	bag
bad	bad
troop	troops
ban	ban,bans
bashar	bashar
hasten	hastened
steal	stealing
valid	validity
respond	respond,responding
protract	protracted
impun	impunity
fair	fair
elimin	eliminating,eliminate
inapt	inapt
resist	resistance,resisted
glad	glad
result	result,resulted
respons	responsibility,responses,responsibilities,responsible
corrupt	corrupt,corruption
best	best
subject	subjected
expertis	expertise
awar	aware
said	said
away	away
fractiou	fractious
nadler	nadler
outstand	outstanding
finger	fingers
simplest	simplest
imprimatur	imprimatur
approach	approach
inabl	inability
accord	according,accordance,accords
extend	extending,extended
kimbal	kimball
metal	metals
extens	extension,extensive
unabl	unable
extent	extent
toler	tolerance
unfound	unfounded
exclud	exclude
protect	protect,protecting,protection,protected
expos	exposing,exposes
unidimension	unidimensional
infract	infractions
fault	faults
howev	however
unemploy	unemployment
ilk	ilk
extraordinarili	extraordinarily
futil	futile
disarma	disarmament
countri	countries,country
uncertainti	uncertainty
compromis	compromise,compromised,compromises
pre	pre
assur	assurance,assured,assurances
tough	tough
royal	royal
excess	excess
resumpt	resumption
unrealiz	unrealizable
karen	karen
aftermath	aftermath
ineffect	ineffective
assum	assuming,assume,assumed
duplic	duplicative
beneficiari	beneficiaries,beneficiary
light	light
masoud	masoud
union	union
convolut	convoluted
three	three
specul	speculate
accumul	accumulation,accumulate
much	much
interest	interests,interested
advers	adversely
repatri	repatriate
disengag	disengagement
tini	tiny
quickli	quickly
chug	chugging
life	life
regul	regulations
dismiss	dismissed
wish	wish,wishful,wishes,wishing
dislodg	dislodging
lift	lifting,lifted
imbroglio	imbroglio
efficaci	efficacy
catch	catches
maloneywhi	maloneywhy
sabotag	sabotage
mohammad	mohammad
alleg	allegations,alleged
inhibit	inhibited
kennan	kennan
tank	tank
affirm	affirms
servic	services
lessen	lessen
commerci	commercial
air	air
lesser	lesser
ail	ailing
near	near,nears
publicli	publicly
aid	aid,aides
possess	possession
gave	gave
anchor	anchor
sanit	sanitize
seven	seven
bellicos	bellicosity
tabl	table
throat	throated
hardlin	hardline,hardliners
hanauer	hanauer
sever	several,severely
grown	grown
inventori	inventory
prior	prior
receiv	receives,received
suggest	suggests,suggested,suggesting
make	make,makes,making
transpar	transparency
preserv	preserve,preserved,preserves,preserving
drawback	drawbacks
split	split
gradat	gradations
complet	completely,completed,completing,completion
constituion	constituional
evid	evidence
saddam	saddam
rain	raines
hand	hand,hands,handed
fairli	fairly
rais	raise,raised
kim	kim
refin	refined
traffick	trafficking
butter	butter
yukiya	yukiya
knockoff	knockoffs
kept	kept
scenario	scenario
thu	thus
hypothet	hypotheticals
qualit	qualitative
client	client,clients
greatest	greatest
programm	programme
everyth	everything
controversi	controversial,controversy
jpoa	jpoa
legisl	legislators,legislative,legislation
left	left
shareabl	shareable
bellow	bellows
facto	facto
capitol	capitol
photo	photo
bandwidth	bandwidth
nineti	ninety
human	human
shorthand	shorthand
yet	yet
languag	language
previous	previously
shiit	shiite
myanmar	myanmar
easi	easy
legion	legion
deterr	deterrence,deterrent
josh	josh
spread	spread
board	board
barria	barria
falter	faltered
els	else
east	east
islamist	islamist
opt	opted,opting
applic	application
newspap	newspaper
mayb	maybe
dagan	dagan
arab	arab,arabs
fusion	fusion
dissid	dissidents
elabor	elaborate
arak	arak
retreat	retreated
apart	apartment
measur	measures,measurements
nephewiran	nephewiran
specif	specifics,specifically
zeal	zeal
contradict	contradict,contradiction
negat	negation
digniti	dignity
night	night
augur	augurs
oxid	oxide
right	right,rights
old	old
relatedli	relatedly
deal	deal,deals,dealing
somehow	somehow
resolv	resolving,resolve,resolves,resolved
born	born
intern	international,internal,internationally
usher	usher
pain	painful
interf	interfering
transmiss	transmission
cede	ceded
cooper	cooperation,cooperate
deploy	deployment,deployed,deployments,deploying
distrust	distrust
existenti	existential
frum	frum
condit	condition,conditioned
price	price
reluct	reluctant
core	core
conced	concede,conceding
sherman	sherman
bold	bold
unsc	unsc
jubil	jubilation
payment	payments
pose	pose,poses,posed
buri	buried
confer	conference
speak	speaking
corp	corps
promot	promote
stride	strides
post	post
super	super
spoke	spoke
dilig	diligently
conceal	concealed,concealment
surround	surrounded,surrounding
simul	simulate
despair	despair
adel	adel
commit	committed,commitment,commitments,commits
produc	produced,producing
unequivoc	unequivocal
redlin	redlines
javad	javad
civil	civil
curiou	curious
profession	professional
bound	bound,bounds
two	two
sop	sop
olc	olc
resili	resilience
coverag	coverage
formerli	formerly
wrap	wrapped
opportun	opportunities,opportunity
storag	storage
squander	squander
preemption	preemption
fabric	fabrication
suffici	sufficiently
overus	overuse
frustrat	frustrates,frustrated
support	supporting,supporters,supported,supports,supportive
wad	wads
transform	transform,transformed,transformation,transforms
happi	happiness,happy
avail	available
stuck	stuck
reli	rely,relies,relying
fought	fought
way	ways
acknowledg	acknowledging,acknowledge,acknowledges,acknowledged
call	call,called,calls,calling
tamp	tamp
war	war,wars
retali	retaliate
analysi	analysis
head	head,heads
form	form,forms,forming
offer	offers,offered
forc	forcing,forces,forced,forceful
rogin	rogin
surveil	surveillance
heat	heated
hear	hears,hearings
safeguard	safeguard,safeguards
true	true
analyst	analyst,analysts
understood	understood
type	types
jcpoa	jcpoa
retic	reticence
bargain	bargain
absenc	absence
fundament	fundamentally
standingspolit	standingspolitics
emir	emirates
penal	penalize,penalized
adopt	adoption,adopts,adopted
alongsid	alongside
covert	covert
shia	shia
flaw	flawed
muscular	muscular
sale	sale,sales
diagnost	diagnostic,diagnostics
exist	exist,existing,existence
glanc	glance
prayer	prayers
desir	desire
bristl	bristling
enlist	enlisted
trip	trip,trips
assembl	assemblies
stake	stake,stakes
excel	excellent
actor	actor,actors
willingli	willingly
role	role,roles
test	test,testing,tests
tie	ties,tied
presum	presumably
nullif	nullification
roll	roll,rolls,rolled
realiti	realities,reality
cleric	clerics
notif	notification
intend	intended
faction	factions,factional
wing	wing
cybersecur	cybersecurity
felt	felt
deton	detonation,detonators
intens	intense,intensity,intensive
intent	intentions
consid	consider,considered,considering,considers
stoke	stoked
derail	derail
billion	billion,billions
outdat	outdated
longer	longer
furthermor	furthermore
gap	gaps
dividend	dividend
exce	exceeds
ignor	ignored,ignoring,ignores
time	time,times,timely
push	pushed,pushing
serious	seriousness,seriously
daili	daily
lawsuit	lawsuit
chain	chain
whoever	whoever
rob	robbed
celebr	celebrating,celebration
centrifug	centrifuges
focus	focused
invent	invented
disfavor	disfavored
signific	significant,significance
recess	recess
skim	skimmed
diplomaci	diplomacy
mill	mills
overtim	overtime
compani	companies,company
decid	decided,deciding,decides
middl	middle
depend	depended,depends,depending,dependable
religion	religion
environment	environmental
rhetor	rhetoric,rhetorical
certainli	certainly
decis	decision,decisive,decisions
terror	terrorism
daryl	daryl
oversight	oversight
geopolit	geopolitical
string	string
minist	minister,ministers
clich	clich
feasibl	feasible
embark	embark
broadli	broadly
octob	october
exact	exact
seemingli	seemingly
administr	administration,administrations,administrative
level	level,levels
necessit	necessitates
dig	dig
democrat	democratic,democrats
gum	gum
item	item,items
roadmap	roadmap
team	team
quick	quick
guy	guys
unaccount	unaccounted
round	rounds
prevent	prevent,prevents,prevented,preventing
regret	regret
tougher	tougher
trend	trend
nietzsch	nietzsche
plu	plus
qatif	qatif
sign	signed,signing,signs
pmd	pmd
cost	cost,costs
helpless	helpless
precipit	precipitate
inconclus	inconclusive
afghanistan	afghanistan
appear	appears,appeared,appearance
currenc	currency
repriev	reprieves
favour	favour
current	current,currently
suspect	suspect,suspected
boost	boost,boosting
cleaner	cleaner
punit	punitive
burn	burns
defici	deficiencies,deficiency
deriv	derived
nuanc	nuanced
guardian	guardian
gener	generate,general,generation,generated,generating,generally
muslim	muslim
upheav	upheaval
water	water
explicitli	explicitly
address	address,addressed,addressing,addresses
deceit	deceit
along	along
waiv	waive,waiving
wait	waiting
buck	buck
hormuz	hormuz
shift	shifting
rethink	rethink
disavow	disavowed
incrimin	incriminating
thirti	thirty
extrem	extreme,extremely
funder	funder
guilti	guilty
elect	elected,election,elections
unbridl	unbridled
extra	extra
circumv	circumvent
derakhshani	derakhshani
prefer	preferable,preferences
timet	timetables
ratif	ratification
leav	leaves,leaving
visibl	visibility
instal	installation,installed,installations
cacophoni	cacophony
mobil	mobilize
market	market,markets
manufactur	manufacturing,manufacture
kontorovich	kontorovich
newslett	newsletter
prove	proved
subvert	subverts
wane	waning
balki	balky
ayatollah	ayatollah
subvers	subversion
everybodi	everybody
live	living,lives,lived
scope	scope
onslaught	onslaught
today	today
capit	capital
afford	afford
peopl	people
claus	clause
finit	finite
refrain	refrain
enhanc	enhances,enhanced
oppressor	oppressor
appel	appellate
kerri	kerry
jeopard	jeopardize
examin	examine
effort	efforts
easiest	easiest
behalf	behalf
religi	religious
impair	impair
discontinu	discontinuing
prepar	prepared,preparations,prepares
pretend	pretend
judg	judging,judge,judged,judges
focu	focus
imper	imperative,imperatives
minimum	minimum
whatev	whatever
imped	impede,impeding
purpos	purposes
materi	material,materials
claim	claim,claimed,claims
underestim	underestimate
trump	trump
kenneth	kenneth
predict	predict,prediction,predicting,predictions
spi	spy
critic	critics,criticism,critical
council	council
sharp	sharp
agenc	agency,agencies
parchin	parchin
unfortun	unfortunately
occur	occur
acced	accede
purs	purse
hasan	hasan
multipl	multiple
winter	winter
tilt	tilted
satisfact	satisfaction
idl	idle
economi	economy,economies
write	writes,writing
alway	always
rubio	rubio
vital	vital
anyon	anyone
sword	sword
sworn	sworn
pathway	pathways
einhorn	einhorn
product	production
intrud	intruding
may	may
spot	spot
intrus	intrusive
mankind	mankind
date	date
drastic	drastically
underscor	underscored
misstat	misstatement
grow	grow
stress	stressed,stressing
unsettl	unsettling
practic	practically,practice
conscious	consciously
favorit	favorite
su	suing,sued
inform	information,informed
switch	switch
preced	preceded,precedence,precedent,preceding
combin	combined
deposit	deposits
hassan	hassan
battl	battles
truce	truce
ordinari	ordinary
talk	talks,talking,talked
shield	shields
anticip	anticipates,anticipation
gradual	gradual,gradually
forfeit	forfeited
moralist	moralistic
approv	approval,approved
stonewal	stonewalling
microscop	microscopic
equip	equipment
cold	cold
still	still
aw	awful
entiti	entities
reinforc	reinforce,reinforced
group	groups
thank	thanks
polici	policies,policy
passag	passage
torn	torn
instantli	instantly
platform	platform,platforms
window	window,windows
jubeir	jubeir
suspicion	suspicions
main	main
hotli	hotly
deviant	deviant
confin	confined
non	non
recal	recall,recalling
halt	halted
civilian	civilian
financi	financial
automobil	automobiles
shatter	shattered
initi	initially,initiation,initiative,initiating,initiatives
nation	national,nations
yourish	yourish
answer	answer,answered
expediti	expeditious
taliban	taliban
therebi	thereby
half	half
son	sons
provision	provisional,provisionally
discuss	discussion,discussions,discussed
introduct	introduction
outweigh	outweigh
term	term,termed,terms
name	name,namely
realist	realistic
stir	stir
drop	dropped
revert	revert
separ	separation,separate,separated,separately
breach	breach,breaches
rock	rock
januari	january
confid	confident,confidence
citat	citations
replac	replace,replacements,replacing
individu	individuals,individually
continu	continue,continues,continuing,continued,continuous,continuation
breakthrough	breakthrough
gird	gird
persian	persian
sponsor	sponsor,sponsoring,sponsors
begun	begun
year	years
okay	okay
happen	happened,happening,happens
dispos	disposal,dispose
conting	contingency
accomplish	accomplished,accomplishment
bullish	bullish
space	space,spaces
profit	profits
pentagon	pentagon
flimsi	flimsy
thirst	thirst
profil	profile
qud	quds
formula	formula
correct	correct,correcting
domest	domestic,domestically
million	millions
argu	arguing,argue,argued,argues
rivkin	rivkin
california	california
rebel	rebels
ore	ore
card	cards
care	cared,careful,carefully
departur	departure
couldn	couldn
unwil	unwilling
modest	modest
british	british
unavoid	unavoidable
motion	motion
thing	thing,things
lie	lies
place	places,placed
nonprofit	nonprofit
principl	principles
neglect	neglects,neglected
frequent	frequently
first	first
oper	operation,operating,operations,operate,operationally,operated
suspend	suspended,suspending
oppon	opponents
directli	directly
withstand	withstand
carri	carry,carried
lone	lonely
oversaw	oversaw
one	one,ones
acquisit	acquisition
suspens	suspensions
submit	submitted,submitting
oppos	opposed,opposing,opposes
array	array
fight	fighting
open	opening
tomorrow	tomorrow
size	size,sized
given	given
capac	capacity,capacities
convent	conventional
caught	caught
fierc	fierce
necessarili	necessarily
draft	drafted
demonstr	demonstrated,demonstrates,demonstrations,demonstrating
circl	circles
white	white
conveni	conveniently
cite	cite
friend	friends
forthcom	forthcoming
hillari	hillary
fraction	fraction
especi	especially
hum	hum
memo	memo
wax	waxed
undoubtedli	undoubtedly
specifi	specified,specifies,specify
broadcast	broadcast
forward	forward
interrel	interrelated
mostli	mostly
tehran	tehran
domin	dominating,dominance,dominate
serv	served
wide	wide,widely
crack	crack,cracking
recruit	recruit
balanc	balance
posit	positive,position,positions
upsurg	upsurge
russia	russia
seri	series
prospect	prospects
pro	pro
anywher	anywhere
sad	sad
dash	dash
say	saying,says
ernest	ernest
deliv	delivered
anger	angered
allen	allen
fordow	fordow
saw	saw
mislead	mislead
engin	engineers
moreov	moreover
note	noting,note,noted,notes
acumen	acumen
ideal	ideal,ideals
lion	lion
take	take,taking,takes
advis	advise,advisers
destroy	destroys,destroyed
wonder	wonderful
blunt	blunt
noth	nothing
channel	channel
surg	surge
begin	begins,beginning
sure	sure,surely
importantli	importantly
trace	traces
normal	normal,normalization
track	track
friedman	friedman
knew	knew
paid	paid
abus	abuses
america	america
rescu	rescued
later	later
drive	drive
quantiti	quantity
badg	badge
meanwhil	meanwhile
senior	senior
preambl	preamble
shot	shot
newer	newer
show	show,shows,showed
cheat	cheat,cheats,cheating,cheated
pursuant	pursuant
merit	merits
threshold	threshold
label	label
ground	ground,grounds
enthusiast	enthusiastically
slow	slow,slowed
gulf	gulf
treasuri	treasury
transact	transactions
activ	activities,active,activity,actively,activism
jolt	jolt
black	black
analys	analyses
nearli	nearly
variou	various
get	getting,gets
irradi	irradiating
cannot	cannot
gen	gen
requir	requires,required,requirements,requiring
truli	truly
prime	prime
reveal	revealed
dramat	dramatically
ahmad	ahmad
disbelief	disbelief
irrespect	irrespective
stupid	stupidity
aris	arise
mediat	mediation
snapback	snapback
summari	summary
dempsey	dempsey
maximum	maximum
triumphalist	triumphalist
deadlin	deadline
afoul	afoul
reserv	reservations
calendar	calendar
concern	concerned,concerns
detect	detect,detecting,detected,detection
televis	television
review	review,reviewed,reviews
transnat	transnational
sponsorship	sponsorship
behind	behind
volatil	volatile
voluntari	voluntary
import	important,importing,imports
paramet	parameters
across	across
ought	ought
hizbullah	hizbullah
assumpt	assumptions
august	august
vocifer	vociferous
blame	blame
cycl	cycle
spare	spare
legitimaci	legitimacy
iaea	iaea
spark	sparked
come	come,coming,comes
reaction	reaction
unrel	unrelated
poke	poke
libya	libya
reluctantli	reluctantly
region	regional,regionally
contract	contracts
inconsist	inconsistent
mani	many
among	among
overview	overview
pot	pot
inspir	inspired
period	period,periods
insist	insist,insisted,insists
exagger	exaggerated
exploit	exploit,exploitation
anti	anti
shortag	shortages
typic	typical
extinct	extinction
poll	polls
taxpay	taxpayer
boat	boat
damag	damage,damaged,damaging
turkey	turkey
save	save
ultim	ultimately
clarif	clarification
coupl	couple
west	west
rebuild	rebuilding
hardli	hardly
mark	mark
breath	breath
workshop	workshops
certifi	certifies,certify
amano	amano
resolut	resolutely,resolution,resolutions
suscept	susceptible
tiger	tiger
catastroph	catastrophic
wake	wake
abject	abject
andrea	andrea
former	former
robber	robbers
pilot	pilots
sound	sounds
slipperi	slippery
codicil	codicils
senat	senate,senator,senators
cast	casting
invok	invoked
ratchet	ratchet
outcom	outcome,outcomes
schwarzeneggerian	schwarzeneggerian
margin	marginalizes,margins
stockpil	stockpile,stockpiles
anytim	anytime
advantag	advantage,advantageous,advantages
strait	strait
convinc	convinced,convincing
worri	worried,worry
stringent	stringent
sudden	sudden
congression	congressional
eras	erasing,erase
pursu	pursue,pursued,pursuing
ship	shipped,shipping
develop	developing,developed,development,develops
harsh	harsh
author	authority,authorization,authorities,authorizing,authorized,authorizes
pay	pay
medic	medical
econom	economic,economically
columnist	columnist
speech	speech
promin	prominence
eventu	eventually
week	week,weeks
exhaust	exhaustive
jeffrey	jeffrey
oil	oil
closest	closest
statut	statute
illicitli	illicitly
confidenti	confidential,confidentiality,confidentially
driven	driven
capabl	capability,capabilities,capable
improv	improving,improve,improvement,improvements,improved
extern	external
postpon	postpones
break	breaks,breaking
isotop	isotope
appropri	appropriate,appropriately
moder	moderates,moderating
reliev	relieved
justifi	justifying
without	without
relief	relief
grappl	grappled
model	model,models,modeling
reward	rewards
roughli	roughly
summer	summer
violenc	violence
execut	executing,executive,execution,executed
zivotofski	zivotofsky
conform	conformed
money	money
rest	rest
imprint	imprint
violent	violent
pariah	pariah
kill	kill
aspect	aspects
exacerb	exacerbating,exacerbate
speed	speed
incentiv	incentivize
concentr	concentrate,concentrations,concentrates
indulg	indulge,indulged
adventur	adventures,adventurism
europ	europe
trigger	trigger,triggers,triggered
except	exceptions
littl	little
instrument	instruments
bigger	bigger
exercis	exercises,exercising,exercised
stagnant	stagnant
struck	struck
pill	pill
momentum	momentum
ross	ross
kingdom	kingdom
hover	hovered,hovers
around	around
amo	amos
read	read,reading
rejoin	rejoining
mou	mou
reassembl	reassembling
regim	regime,regimes
grid	grid
conscienti	conscientiously
world	world
rebecca	rebecca
unwilling	unwillingness
dare	dare
meat	meat
duti	duty
escalatori	escalatory
shrink	shrink
chamber	chamber,chambers
republ	republic
either	either
cascad	cascades
manag	managed
fulfil	fulfilled,fulfillment
shibley	shibley
lebanon	lebanon
matur	mature,maturation
haass	haass
satisfactori	satisfactory
adequ	adequate
fatwa	fatwa
undermin	undermine
sen	sen
intact	intact
constitut	constitutional,constitute
bless	blessing
confirm	confirms,confirmation
tube	tubes
benefici	beneficial
definit	definitive,definition
token	token
legal	legal,legally,legalizes
intract	intractable
evolv	evolve
devot	devotes
notabl	notably
freed	freed
dealimplicitli	dealimplicitly
immun	immune
power	power,powers,powerful
sixti	sixty
ration	rational
pluralist	pluralistic
broken	broken
leadership	leadership
fulli	fully
comparison	comparison
central	central
solidifi	solidify,solidified,solidifying
testimoni	testimony
drag	drag,dragging
degre	degrees
hama	hamas
stand	stand,standing,stands
neighbor	neighbors
act	acted,acting
industri	industrial,industrialize
assassin	assassinate
ideologu	ideologues
allianc	alliance
road	road
berger	berger
effici	efficient,efficiency
elementari	elementary
lastli	lastly
verifi	verify,verifying,verified,verifiable
surviv	survive
odd	odds
inbox	inbox
garner	garnered
quiz	quiz
stare	staring
fast	fast
complianc	compliance
area	areas
aren	aren
glean	gleaned
start	start,starting,starts,started
low	low
lot	lot,lots
submiss	submission
strictli	strictly
mightili	mightily
enorm	enormously
timelin	timeline
mischief	mischief
enough	enough
conclud	concluded,concludes,concluding
regard	regarded,regarding,regards
concess	concessions
idea	idea
evas	evasions
procedur	procedural,procedures
illus	illusion,illusions
trickier	trickier
conclus	conclusion,conclusions
faster	faster
pull	pulled
rush	rush
possibl	possible,possibly,possibility
unusu	unusual
pompeo	pompeo
connect	connections
natanz	natanz
gone	gone
amongwhat	amongwhat
citizenship	citizenship
creat	created,creating
certain	certain
deep	deep
fellow	fellow
strongli	strongly
britain	britain
decreas	decrease
yemeni	yemeni
file	file
syrian	syrian,syrians
fill	fill,filled
incorrect	incorrect
personnel	personnel
compel	compel,compelled,compels,compelling
reduct	reduction,reductions
field	field,fields
cleanup	cleanup
compet	competing
middleburi	middlebury
immens	immense
ceaselessli	ceaselessly
architectur	architecture
poor	poor
discours	discourse
authoritarian	authoritarianism
congress	congress
annex	annex,annexes
symbol	symbolic
teeth	teeth
prudenc	prudence
lacklust	lackluster
netanyahu	netanyahu
brotherhood	brotherhood
peac	peace,peaceful,peacefully
reduc	reduce,reduced,reducing,reduces
bulk	bulk
escal	escalation,escalating
invest	investment,invested,investments
descript	description
kilogram	kilograms
inevit	inevitable,inevitably
mass	mass
adam	adam
potenti	potentially
god	god
escap	escape
waiver	waivers
forget	forgetting
ali	ali
recip	recipe
lack	lacked,lacking,lacks
dollar	dollars
month	months
atlant	atlantic
abil	ability
follow	follow,follows,following
illicit	illicit
abid	abided,abides
edg	edging
inconceiv	inconceivable
schiff	schiff
overwhelmingli	overwhelmingly
articl	article
propon	proponents
aaron	aaron
program	program,programs
unsurpris	unsurprising
countless	countless
norm	norms
wmd	wmd
case	case,cases
global	global
straightforward	straightforward
egyptian	egyptian
far	far
fat	fat
rouhani	rouhani
util	utility,utilizing
candid	candidate,candidates
mechan	mechanism
allur	alluring
fall	falls
strand	strand
forth	forth
wsj	wsj
colleagu	colleagues
director	director
destabil	destabilizing,destabilize
supplement	supplement,supplemented
saudi	saudi,saudis
small	small
dimens	dimension,dimensions
neighborhood	neighborhood
ga	gas
ten	ten
boondoggl	boondoggles
unconstrain	unconstrained
sync	sync
past	past
soleimani	soleimani
zero	zero
pressur	pressure,pressures
design	designations,designed,designs,designate,designated,designing,designating
unrecover	unrecoverable
pass	passes,passing,passed
nbc	nbc
casual	casually
belief	belief
will	willing
deleg	delegation
richard	richard
clock	clock
skeptic	skeptical,skeptics,skeptically
sum	sum
abl	able
brief	briefed,briefings
schumer	schumer
consecut	consecutive
deepli	deeply
public	publics
contrast	contrast
movement	movement,movements
turmoil	turmoil
hasn	hasn
full	full
iran	iran
empower	empowerment
deris	derisively
sophist	sophistication,sophisticated
behaviour	behaviour
shouldn	shouldn
omiss	omission
inher	inherent
strong	strong
modifi	modified,modify
valu	values
arena	arenas
misinterpret	misinterpreted,misinterpreting
naval	naval
ahead	ahead
brutal	brutal,brutality
soldier	soldier,soldiers
amount	amount,amounts
pick	pick,picking
action	action,actions
narrow	narrow
medicin	medicinal,medicines
depart	department,departing
unconstitut	unconstitutional,unconstitutionally
declin	declining,decline,declined
primit	primitive
transit	transitioned
friendli	friendly
put	puts,putting
sanction	sanctions,sanctioned,sanctioning
suddenli	suddenly
establish	establishment,established,establishing
dangl	dangle
select	selective
aggress	aggressive,aggression,aggressively
eye	eyes,eyed
proceed	proceed,proceeding
iraqi	iraqi
liber	liberalizing
etc	etc
supposedli	supposedly
hegemoni	hegemony
chaotic	chaotic
morn	morning
interdict	interdict,interdicting,interdictions
taken	taken
kick	kick,kicked
minor	minorities
israel	israel
door	door,doors
materiel	materiel
preciou	precious
stick	stick
particular	particular,particulars
known	known
mellow	mellowing
intertextu	intertextual
dictat	dictates
none	none
hous	house,houses,housed
pollack	pollack
outlin	outline,outlined
histori	history
remain	remain,remains,remaining,remained
hesit	hesitant,hesitate
nine	nine
abandon	abandon,abandoned
yemen	yemen
disapprov	disapproval,disapproving
prompt	prompt
dual	dual
buttress	buttresses
challeng	challenge,challenges,challenging
share	share,shared,sharing
accept	accept,accepted,acceptable
takeyh	takeyh
sourc	source,sources
noncompli	noncompliance
attain	attain
explos	explosive,explosively,explosives
phrase	phrased
condemn	condemnation,condemns
inescap	inescapable
huge	huge
cours	course
court	courts,courting
goal	goals
secur	security,secure,securing,secured
rather	rather
anoth	another
warhead	warheads
renew	renewed
everyday	everyday
divis	divisions,divisive
herzliya	herzliya
reject	reject,rejected,rejecting,rejection,rejects
simpl	simple
isn	isn
plant	plant,plants
resourc	resources
threat	threat,threats
referenc	referencing
flip	flip
sneak	sneak,sneaking
reflect	reflects
embrac	embracing,embrace
substanti	substantial,substantially
associ	associated,association
reelect	reelect
stabil	stability
short	short
caprici	capriciously
jihadist	jihadists
overnight	overnight
ambigu	ambiguities,ambiguous
caus	caused
jaffari	jaffari
media	media
shadi	shadi
dream	dream
preposit	prepositioning
constitu	constituency
help	helps,helped,helping,helpful
fantasi	fantasy
erod	erode
beinart	beinart
soon	soon
setback	setbacks
trade	trading,trade,trades
held	held
scientist	scientists
scott	scott
suffer	suffer,suffering
eros	erosion
pray	pray
ostovar	ostovar
bosom	bosom
alli	allies,ally
late	late
resort	resort
rapidli	rapidly
might	might
wouldn	wouldn
good	good,goods
return	return,returns
amelior	ameliorate
ye	yes
wast	waste
framework	framework,frameworks
foot	foot
detach	detachment
complain	complained,complains
procliv	proclivity
document	document,documents
mysteri	mysteries
easili	easily
achiev	achieved,achievement,achieving,achieves,achievable,achievements
undertak	undertake
ceas	cease
found	found
intervent	interventions
reminisc	reminiscent
denni	dennis
shock	shocked
weight	weight
unilater	unilateral
multilater	multilateral
hard	hard
ilitari	ilitary
fractur	fracturing
realli	really
heavi	heavy
linkag	linkage
expect	expect,expected,expectations
balk	balks
energi	energy
beyond	beyond
event	event
retribut	retribution
safeti	safety
admiss	admission
suprem	supreme
shortcom	shortcomings
robert	robert
partli	partly
research	research
hayden	hayden
sustain	sustain,sustained
hill	hill
shipment	shipment,shipments
testifi	testified
benjamin	benjamin
difficulti	difficulties
assist	assistance,assisted,assistant
proxi	proxies
uncommit	uncommitted
advanc	advancing,advance,advanced
obamacar	obamacare
dissoci	dissociating
gut	guts
suspici	suspicious
backer	backers
lobbi	lobby,lobbying
reason	reason,reasonable,reasons,reasoning
base	base,based,bases
believ	believe,believed,believes
murmur	murmur
ask	asking,asks,asked
basi	basis
prefac	preface
precari	precarious
launch	launch
veloc	velocity
struggl	struggle
revolutionari	revolutionary
omin	ominously
american	american,americans
perman	permanently
penetr	penetration
testament	testament
syria	syria
lifetim	lifetime
feed	feed
major	major,majority
notifi	notify
obviou	obvious
feel	feel,feeling
exchang	exchange
number	number,numbers
understat	understatement
smaller	smaller
done	done
construct	construction,constructing,constructive
descent	descents
stabl	stable
downsid	downside
miss	missed
defi	defying
carter	carter
differ	different,difference,differences
yadlin	yadlin
contra	contra
least	least
jeb	jeb
paint	paint
stori	story
iraq	iraq
lab	labs
store	stored
conduit	conduit
imperfect	imperfections
option	options,optional
relationship	relationships
lawmak	lawmakers
compens	compensate
insurg	insurgency
illeg	illegal,illegally
part	part,parts
pars	parsed
consult	consult,consultation
theater	theater
rampant	rampant
obama	obama
albeit	albeit
kind	kind,kinds
grew	grew
contrari	contrary
iranian	iranian,iranians
remot	remote
gotten	gotten
remov	removed,removing,removal
vocal	vocal
youth	youth
stall	stalling,stalls
quarterli	quarterly
reinstat	reinstated
postur	posture,posturing
toward	toward,towards
beij	beijing
diversifi	diversify
breakneck	breakneck
wsjthinktank	wsjthinktank
comput	computer
exert	exert
strengthen	strengthening,strengthened
grandios	grandiose
packag	package
expir	expires,expiration
dedic	dedicated
gangbust	gangbusters
sell	sell
mountain	mountain
entireti	entirety
tranch	tranche
built	built
carlo	carlos
self	self
violat	violates,violations,violating,violated
troublesom	troublesome
undeclar	undeclared
also	also
build	build,building,buildings
maloneywil	maloneywill
schedul	schedule
play	play,played,plays,playing
temptat	temptation
previou	previous
reach	reached,reaching,reaches
utmost	utmost
react	reacted
prolifer	proliferation
plan	plans,planning
charg	charges
amaz	amazing
ballist	ballistic
clear	clear
cover	covered,covers
destruct	destruction,destructive
clean	clean
jordan	jordan
barrel	barrel
latest	latest
standoff	standoff
sector	sectors
gold	gold
memorandum	memorandum
statecraft	statecraft
session	session
particularli	particularly
employ	employing
fine	fine
find	find,finding
abund	abundance
penalti	penalties,penalty
ambit	ambitions
justici	justiciability
pretti	pretty
nervous	nervousness
solut	solution
factor	factor,factors
stipul	stipulate
unhappi	unhappiness,unhappy
hit	hit
custodian	custodian
express	expressed
intensifi	intensify
resent	resentments
deliber	deliberation
hid	hid
ambiti	ambitious
meir	meir
sunni	sunni
renegoti	renegotiate
silo	siloing
proclaim	proclaimed
antiqu	antiquated
enemi	enemy,enemies
interim	interim
common	common
switzerland	switzerland
rudimentari	rudimentary
respit	respite
ouster	ouster
wrote	wrote
commod	commodities
certif	certification
set	set,sets
art	art
outwardli	outwardly
reimposit	reimposition
overwhelm	overwhelming
see	see,seeing,sees
bare	barely
disadvantag	disadvantages
arm	arms,armed,arming
expert	experts
mine	mined,mines
someth	something
particip	participating,participants,participate,participated
debat	debating,debate,debated,debates
woo	woo
won	won
myriad	myriad
woe	woes
experi	experience
nope	nope
altern	alternative,alternatives,alternatively,alternate
blow	blow
korea	korea
hardship	hardship
numer	numerous
induc	induced,inducement
aspir	aspirations,aspires
isol	isolation,isolated
aircraft	aircraft
death	deaths
arrang	arrangements
solv	solve
nervou	nervous
popul	population
satisfi	satisfying,satisfied
last	last,lasting
alon	alone
grudg	grudging
foreign	foreign,foreigners
context	context
forgotten	forgotten
protector	protector
whole	whole
cynic	cynical
simpli	simply
point	point,pointed
hexafluorid	hexafluoride
loan	loans
derid	deride
sweep	sweeping
unrealist	unrealistic
hollow	hollow
residu	residual
jure	jure
provok	provoke
shutdown	shutdown
suppli	supplying,supplies,supplied
vessel	vessels
mistak	mistake
throughout	throughout
provoc	provocations
bolster	bolstering,bolstered
devil	devil
angrythi	angrythis
nader	nader
territori	territory
devic	device,devices
due	due
perpetu	perpetuate,perpetuation
dug	dug
secret	secret
threaten	threatening,threatened
devis	devising
woke	woke
strategi	strategy
firm	firm,firms
champion	championed
mind	minded
exempt	exempted
great	great
deter	deter,deterring
fund	funds,funded,funding
irgc	irgc
understand	understandable,understanding,understandably,understandings,understands
demand	demand,demanded
heighten	heightened
vulner	vulnerability,vulnerabilities
honest	honest
pact	pact,pacts
loom	looming
politician	politicians
look	look,looks,looking,looked
frozen	frozen
histor	historic
governor	governors
durat	duration,durations
pace	pace
litig	litigation,litigated
unifi	unifying
smart	smart
behavior	behavior
error	error
clarifi	clarifying
everyon	everyone
subsect	subsection
real	real
pragmat	pragmatic
readi	readiness
centr	centre
rip	rip
vow	vowed
headway	headway
centuri	century
minutia	minutia
minim	minimizing,minimize
theocrat	theocratic
shorten	shorten
lengthi	lengthy
ray	ray
conflict	conflict,conflicts
higher	higher
maneuv	maneuver
goodwil	goodwill
imagin	imagine,imagined,imagining
optim	optimism
restraint	restraints
troublemak	troublemaking
inflat	inflation
alert	alerts
moment	moments
user	user
inflam	inflame
robust	robust
chang	change,changes,changing
recent	recent,recently
hows	howse
expend	expending
task	task
vitriol	vitriolic
ampl	ample
unanim	unanimous
spent	spent
person	personal
cheer	cheers
withdraw	withdrawal
commentari	commentary
grip	grip
spend	spend,spending
propos	propose,proposals,proposed,proposing
explan	explanation
ambassador	ambassador
unrelentingli	unrelentingly
buchanan	buchanan
bilater	bilateral
obscur	obscure
collabor	collaboration
relianc	reliance
shape	shape
regardless	regardless
mandat	mandated
cut	cut,cuts,cutting
reap	reap
boutiqu	boutique
persuad	persuade,persuading
snag	snag
barack	barack
eager	eager
appli	apply,applies,applying
snap	snap,snapped
cum	cum
subsequ	subsequent
limp	limping
chairman	chairman
complaint	complaints
marco	marco
march	march
marci	marcy
stein	stein
insert	insert
big	big
rebound	rebound
intuit	intuitive
injur	injure
preexist	preexisting
modernis	modernised,modernisation
game	game
bit	bit
discriminatori	discriminatory
formal	formally
knock	knock
outright	outright
lost	lost
overcompens	overcompensate
confront	confrontation,confronted,confrontational,confronting
signal	signaled
jcopa	jcopa
rehabilit	rehabilitate,rehabilitating
manifest	manifestations
heart	heart
collect	collectively
princip	principal,principally
popular	popularity
interestingli	interestingly
foolish	foolish
encount	encounters
sketch	sketched
often	often
urgenc	urgency
spring	spring
back	back,backing,backed
extremist	extremist,extremists
urgent	urgently
strongest	strongest
unspecifi	unspecified
sampl	sampling
insur	insurance
surpris	surprising,surprise,surprises
abundantli	abundantly
scale	scale
benefit	benefits
prop	prop
recognit	recognition
pen	pen
larg	large,largely
nonprolifer	nonproliferation
machin	machines
hammond	hammond
run	run
squirrel	squirrel
martin	martin
agreement	agreement,agreements
viabl	viable
step	step,steps,stepped,stepping
prerequisit	prerequisite
andi	andy
impos	imposed,imposing
faith	faith
cautious	cautiously
constraint	constraints
preclud	preclude
crisi	crisis
drama	drama
sake	sake
revolut	revolution
disclosur	disclosure
militia	militia,militias
delist	delists
gambit	gambit
block	block,blocking
cutoff	cutoff
univers	university
clinton	clinton
primarili	primarily
visit	visit
within	within
militarili	militarily
jimmi	jimmy
ensur	ensure,ensures,ensuring
lesson	lesson,lessons
announc	announced,announcement
underst	understate
durabl	durability
inclus	inclusive,inclusion
institut	institutions,institutional,institute
pundit	pundits
question	question,questions
percept	perception,perceptions
long	long
custom	customers
crackdown	crackdown
includ	including,include,included,includes
suit	suit
islam	islamic
vienna	vienna
blueprint	blueprints
larri	larry
repeatedli	repeatedly
khamenei	khamenei
link	link,linked,links
translat	translation
usurp	usurpation
atom	atomic
nefari	nefarious
line	lines
isra	israeli,israelis
outpost	outpost
cia	cia
consist	consistent,consisting
prelud	prelude
up	upping
intim	intimate
redress	redress,redressable
highlight	highlights
similar	similar
skittish	skittish
constant	constant
ralli	rally
chao	chaos
doesn	doesn
repres	representing,representatives,represents
incomplet	incomplete
clever	clever
curb	curb,curbing,curbs
overcom	overcome
home	home
reimpos	reimpose,reimposing,reimposed,reimposes
prevail	prevailing
pedigre	pedigree
reintegr	reintegrate
uranium	uranium
appendic	appendices
consequenti	consequential
draw	drawing
polic	police
scrub	scrubbing
freez	freeze
missil	missile,missiles
meaning	meaningful
reportedli	reportedly
vigil	vigilant
evad	evade,evaders
deserv	deserved
ago	ago
fighter	fighters
lead	leads,leading
dismantl	dismantle
wsjpolit	wsjpolitics
remit	remit
notion	notion
feud	feud
summit	summit
overton	overtones
walker	walker
dismal	dismal
convert	converted
moniz	moniz
essay	essay
monterey	monterey
code	code
unclassifi	unclassified
broaden	broaden
alien	alienate,alienation
cogniz	cognizable
broader	broader
go	going
bait	bait
metallurgi	metallurgy
privat	private,privately
procur	procurement,procurements
jurisdict	jurisdiction
uphold	uphold
sensit	sensitive,sensitize
elsewher	elsewhere
young	young
send	send
statutori	statutory
lower	lower
estim	estimated,estimates
sens	sense,sensing
whichev	whichever
nichola	nicholas
disclos	disclose
nomine	nominee
wave	wave
assad	assad
relev	relevant,relevance
tri	trying,tried,tries
jerrold	jerrold
magic	magical,magically
succeed	succeed
counterproduct	counterproductive
complic	complicated,complicates,complicating
perceiv	perceived
michael	michael
financ	financing,finances
race	race,racing
appar	apparently
dealt	dealt
refer	references,referred,referring
barbara	barbara
pleas	please
hinder	hindered
impli	implying
cap	capping
sovereign	sovereign
natur	nature,natural,naturally
mediterranean	mediterranean
policymak	policymaking,policymakers
jump	jumps
earth	earth
cfr	cfr
folk	folks
houthi	houthis
undetect	undetected
compar	compares,compared
access	access,accessing
experiment	experimentation
turnaround	turnaround
proffer	proffer
bluntli	bluntly
impact	impact
inspect	inspections,inspected
led	led
chose	chose
absolut	absolutely
reza	reza
bodi	body
let	let,letting
lew	lew
cadr	cadre
becom	becomes,becoming
fifteen	fifteen
sinc	since
mindset	mindset
colleg	college
remark	remarks,remarkably,remarkable
didn	didn
convers	conversation,conversion
larger	larger
technolog	technology,technologies,technological,technologically
revenu	revenues
asad	asad
survey	survey
defeat	defeating,defeated
earli	early
opinion	opinions
implement	implementation,implements,implementing,implemented
hemorrhag	hemorrhaging
chanc	chance,chances
daybreak	daybreak
danger	dangerous,dangers,dangerously
egypt	egypt
win	wins,winning
approxim	approximately
emot	emotions
foundat	foundations,foundational
austria	austria
presidenti	presidential
salehi	salehi
deputi	deputies
use	used,using,uses
metaphor	metaphor
contempl	contemplated,contemplates
commun	community
doubl	double
coordin	coordinator,coordinates,coordinated
next	next
implic	implications
hostag	hostages
doubt	doubt,doubted
advoc	advocate,advocates
ministeri	ministerial
stage	stage,stages
lewi	lewis
sort	sort,sorts
parliament	parliament
sharpli	sharply
mikulski	mikulski
impress	impression
train	training
rare	rarely
gambl	gamble
iii	iii
greatli	greatly
account	account,accounting,accounts,accountable
deservedli	deservedly
mossad	mossad
stroke	strokes
obvious	obviously
meet	meetings,meets
aliv	alive
proof	proof
control	control
weaker	weaker
bent	bent
patron	patron
process	process,processing,processed,processes
lock	locked,locks
calcul	calculated,calculating
justif	justification,justifications
high	high
piecem	piecemeal
keller	keller
tab	tabs
sought	sought
gcc	gcc
forese	foreseeable
grudgingli	grudgingly
six	six
dealand	dealand
georg	george
delay	delaying,delayed,delays
democraci	democracy
instead	instead
reestablish	reestablish
stock	stocks
nullifi	nullifying
tension	tensions
impervi	impervious
singular	singular
farm	farm
stop	stop,stopped,stopping
payrol	payroll
attent	attention
ethnic	ethnic
npt	npt
redund	redundant,redundancy
hawk	hawks
physic	physical,physics
alloc	allocated
essenti	essential,essentially
bind	binding,binds
counter	countering
liner	liners
element	elements
issu	issue,issues,issued,issuing
scoop	scoops
chief	chief,chiefs
allot	allotted
agenda	agenda
elid	eliding
reuter	reuters
interlocutor	interlocutors
move	moves,moved,moving
elit	elite
comma	commas
narr	narrative
abjur	abjure,abjured
perfect	perfect
parliamentari	parliamentary
consensu	consensus
decay	decay
pellet	pellets
brook	brookings
lausann	lausanne
whether	whether
willing	willingness
restrain	restrain
infrastructur	infrastructure
decad	decade,decades
therefor	therefore
cusp	cusp
prosper	prosperity
greater	greater
nonnuclear	nonnuclear
handl	handling,handled
overal	overall
strateg	strategic,strategically
mention	mentioned
designe	designee
facilit	facilitation,facilitating,facilitate,facilitates,facilitator
overst	overstate
front	front,fronts
afshon	afshon
republican	republican,republicans
day	days
successor	successor,successors
somewher	somewhere
anyth	anything
edit	edited
truth	truth,truthful
masteri	mastery
subset	subset
societi	societies,society
thwart	thwart
map	map
intellig	intelligence
upris	uprisings
illegitim	illegitimate
imposit	imposition
bay	bay
special	specialized
twice	twice
influenc	influence
defend	defends,defenders,defending
identifi	identify
repress	repression,repressive,represses
categori	categories,category
secretli	secretly
activist	activists
rel	relative,relatively
reformist	reformist,reformists
stun	stunning
defens	defense
red	red
obsess	obsessive
franc	france
shut	shut
umbrella	umbrella
insid	inside
regulatori	regulatory
manipul	manipulation
nephew	nephew
invad	invade
telhami	telhami
york	york
advisor	advisors
releas	released,releasing
philip	philip
likelihood	likelihood
afterward	afterward
quo	quo
promptli	promptly
legitim	legitimate,legitimized
cri	cry
spill	spilled
outsiz	outsized
could	could
clandestin	clandestine
david	david
counterpart	counterpart,counterparts
elector	electorate
enforc	enforcer,enforcement,enforcing,enforced
outsid	outside
presid	president,presidency,presidents
retain	retain,retains
south	south
endors	endorsed,endorsing,endorsement
qualiti	quality
scene	scene
echo	echoed
genuin	genuine
muhammad	muhammad
overdrawn	overdrawn
facil	facilities,facility
suffic	suffices
prioriti	priority,priorities
strict	strict
laps	lapse
system	system,systems
eighth	eighth
attach	attachments,attached
attack	attack,attacking,attacks,attacked
expenditur	expenditures
astoundingli	astoundingly
termin	termination,terminate,terminated,terminating
final	final,finally,finalization,finalized
boil	boils
zarif	zarif
stomach	stomach
retrench	retrenchment
juli	july
diminish	diminish
reaffirm	reaffirmed,reaffirms
nobodi	nobody
haven	haven
slack	slack
richer	richer
structur	structural,structure
charact	character
collaps	collapse
seriou	serious
dubiou	dubious
bet	bet,betting
thereaft	thereafter
clearli	clearly
trainer	trainers
tide	tide
fail	fail,fails,failings,failed
thereto	thereto
goldberg	goldberg
coher	coherent
close	close,closing,closed,closely
need	needs,needed
border	borders
superflu	superfluous
rotor	rotors
rosier	rosier
rout	route
mid	mid
mix	mixed
unawar	unaware
divert	diverted
singl	single
scrutinis	scrutinise
radioact	radioactive
unless	unless
allow	allows,allowed,allowing
combat	combating
preliminari	preliminary
transmit	transmit,transmitted
siphon	siphoning
discov	discovered
skirmish	skirmishes
visa	visas
eight	eight
inoper	inoperable
class	class
urg	urge,urging,urged
dens	dense
gather	gathered,gathering
request	requests
face	faces,faced,facing
inde	indeed
deni	denied
determin	determination,determined,determines,determinations
updat	update
constrain	constrain,constrained
fact	fact,facts
affair	affairs
lebanes	lebanese
text	text
anyway	anyway
indispens	indispensable
bring	bring,brings,bringing
empir	empire
utter	utter
fear	fearful,fears,fearing
texa	texas
eas	ease
staff	staff
textual	textual
locat	location,locations
nois	noise
jay	jay
byrd	byrd
forev	forever
prolong	prolonging
gestur	gesture
satan	satan
intrigu	intriguing
fuel	fueled,fuels
local	local
hope	hopes,hoping,hoped,hopefuls
meant	meant
embargo	embargo,embargoes
insight	insights
contribut	contribute,contributed,contribution
abba	abbas
cuba	cuba
familiar	familiar
disagre	disagree
pave	pave
joint	joint
bean	beans
foremost	foremost
increas	increase,increasing,increased,increases
spur	spurred
multiyear	multiyear
endless	endless
enabl	enable,enables
organ	organizations,organizing
graduat	graduate
hamidnetanyahu	hamidnetanyahu
devast	devastate,devastating
stuff	stuff
contain	contain,containing,containment,contains,contained
rein	rein
grad	grad
view	view,viewed,views
shapiro	shapiro
legaci	legacy
arsen	arsenal
theocraci	theocracy
credibl	credible,credibility
frame	frames
knowledg	knowledge
portend	portends
entitl	entitled
closer	closer
mileston	milestones
statu	status
correctli	correctly
reform	reformers,reforms,reformism
reassert	reassertion
nuclear	nuclear
misus	misuse
brunt	brunt
tend	tend
favor	favor,favored,favorable
state	states,stated
unravel	unravel
crude	crude
progress	progress,progressed,progressive
torpedo	torpedoing
rigor	rigorous
sold	sold
repackag	repackaging
ken	ken
neither	neither
oversold	oversold
covertli	covertly
rejoind	rejoinder
job	jobs
entir	entirely
key	key
disput	disputes,disputed
swift	swift
addit	additional,additionally,additive
etr	etre
buster	busters
career	career
ramp	ramp
equal	equally
roil	roiled
araqchi	araqchi
april	april
admit	admitted
instanc	instance,instances
committe	committee,committees
swallow	swallow
comment	comment,comments
unclear	unclear
tuesday	tuesday
arriv	arrive
walk	walk,walked
news	news
respect	respect,respective
sanger	sanger
ad	added
quit	quite
slowli	slowly
decent	decent
obstacl	obstacle
insuffici	insufficient
compon	components
quid	quid
besid	besides
treat	treat,treated
gaza	gaza
trajectori	trajectory
immedi	immediately
mike	mike
harshest	harshest
presenc	presence
forestal	forestalling
emirati	emirati
assert	assert,assertive,assertions,asserts,assertiveness,asserted
togeth	together
antagon	antagonism
plausibl	plausible
present	present,presented,presentation,presently
scrutini	scrutiny
multi	multi
jaundic	jaundiced
plain	plain
harder	harder
harden	harden,hardened
defin	define,defined,defining,defines
observ	observing,observance,observers
layer	layered
purchas	purchase,purchasing,purchaser,purchases
engag	engagement,engaging,engaged
federica	federica
almost	almost
dissent	dissent
coteri	coterie
site	site,sites
motiv	motivation
raison	raison
arabia	arabia
partner	partners
inspector	inspectors
surprisingli	surprisingly
scienc	science
terrorist	terrorist
welcom	welcome
parti	parties,party
began	began
cross	cross
member	members
largest	largest
underground	underground
bazaari	bazaaris
strangl	strangling
difficult	difficult
competit	competition
tighten	tightening
undesign	undesignated
columbia	columbia
expans	expansion
upon	upon
effect	effectively,effectiveness,effects
sooner	sooner
student	students
spree	spree
afghan	afghan
judgment	judgment,judgments
collar	collared
expand	expand,expanded,expanding
rift	rifts
retard	retarding
center	center,centers
nevertheless	nevertheless
weapon	weapon,weapons,weaponization
nonetheless	nonetheless
well	well
feebl	feeble
thought	thought,thoughtful
exampl	example
command	commanders
choos	choose,chooses,choosing
undefin	undefined
usual	usually
lest	lest
distanc	distance
paus	pause
less	less
obtain	obtainable,obtaining
gun	guns
alireza	alireza
enmesh	enmeshed
abat	abating
heavili	heavily
increasingli	increasingly
paul	paul
simultan	simultaneously
systemat	systematic
web	web
rapid	rapid
onward	onwards
priorit	prioritize
add	add
book	book,books
citizen	citizens
crossroad	crossroads
warrant	warranted
enact	enacting,enacted
rememb	remembered
legitimis	legitimises
arguabl	arguably,arguable
cruz	cruz
realiz	realize
five	five
know	knows,knowing
press	pressed,pressing
redesign	redesigning,redesigned
loss	loss
sissi	sissi
like	like,likely
success	success,successful,succession,successfully
incred	incredible
corpor	corporation
profound	profound
doctrin	doctrine
crise	crises
necessari	necessary
journalist	journalist
lose	lose,losing
scuttl	scuttling,scuttle
soft	soft
page	pages
heel	heels
revers	reverse,reversing
glare	glaring
incent	incentive,incentives
propel	propelled
captur	captured
wheeler	wheeler
rave	rave
weaponri	weaponry
export	export,exporting,exports
convey	conveyed
smoothli	smoothly
guarante	guarantee,guaranteeing,guaranteed,guarantees
peter	peter
transport	transport,transportation
trust	trust,trusted
competitor	competitors
wendi	wendy
broad	broad
avoid	avoid,avoids,avoiding,avoided,avoidance
condens	condensed
lean	leaning
strenuou	strenuous
overlap	overlap
breakout	breakout
jeremi	jeremy
nake	naked
leader	leaders
forbid	forbids,forbidding
regain	regain
encourag	encourage
investig	investigate
worthi	worthy
journal	journal
fordo	fordo
adversari	adversaries,adversary
expansion	expansionism
paper	paper
disregard	disregard,disregarded
host	host
although	although
offset	offset
panel	panel
actual	actual,actually
interven	intervene
justic	justice
freedom	freedoms
sectarian	sectarianism
fissil	fissile
statement	statements
unconstitution	unconstitutionality
embryon	embryonic
disabl	disabling
outset	outset
desper	desperate
fresh	fresh
unwind	unwind
eventdeb	eventdebating
uncertain	uncertain
washington	washington
automat	automatic,automatically
assess	assessing,assessments
guard	guards,guarded
mere	merely
leverag	leverage
pictur	picture,pictures
transfer	transfer,transfers,transferring
spiral	spiral
appl	apples
glimmer	glimmer
biggest	biggest
adher	adhere
buy	buy,buys,buying
north	north
subsum	subsumed
basic	basically
experienc	experienced
neutral	neutral
wealthier	wealthier
gain	gain,gained,gains
technician	technicians
culmin	culminates
highest	highest
count	counting,counted
succe	succeeds
made	made
vigor	vigorously
seiz	seize,seized
unlock	unlocked
troubl	troubling,trouble,troubled,troubles
record	record
limit	limits,limitations,limited,limiting
indefinit	indefinitely
otherwis	otherwise
problem	problem,problems
display	display
plutonium	plutonium
significantli	significantly
evalu	evaluate,evaluation
filibust	filibuster
novemb	november
counterargu	counterargument
ink	ink,inked
workabl	workable
probabl	probably,probability
diplomat	diplomatic,diplomats,diplomatically
contest	contest
guidanc	guidance
latch	latch
percent	percent
detail	details,detailed
virtual	virtual
other	others
futur	future
branch	branch
varieti	variety
burwel	burwell
rial	rial
reckless	reckless
windfal	windfall
repeat	repeated
oversea	overseas
irrespons	irresponsible
june	june
stay	staying
indefens	indefensible
airtight	airtight
repeal	repeal
vein	vein
appoint	appointed
outsourc	outsourced
acquiesc	acquiesce
scientif	scientific
airpow	airpower
reliabl	reliable,reliably
rule	rule,rules,ruling
emerg	emerge,emerges,emerging,emergence
perhap	perhaps
decemb	december
confess	confession
buoy	buoyed
